111101111111
10C00Z00E001
100000C00001
10P000J00C01
111111111111