111111111111
10C00000E001
100000C00001
10P00000C001
111111111111