111111111111
10C00000E001
100000C00001
10P000000C01
111111111111