111111111111
10C000000E01
100000C00001
10P00000C001
100000000001
100000000001
1000C0000001
111111111111